####################################################################################################
## ########                                             ############################################
## ########################### ######################## ############################################
## ########################### ######################## ############################################
## ########################### ######################## ############################################
## ##                          ######################## ########################                   O
## ## ########## ###################################### ######################## ###################
## ## ########## ###################################### ######################## ###################
## ## ########## ###################################### ######################## ###            ####
##    ########## ############         ################# ######################## ### ########## ####
################ #################### ################# ######################## ### ###     ## ####
################ #################### ################# ######################## ### ####### ## ####
###              #################### ################# ######################## ###         ## ####
### ############ #################### ################# ######################## ############## ####
### ######## ### ####################                                                           ####
### ######## ### ########################## #################################### ###################
### ######## ### ########################## #################################### ###################
###          ### ######                                   ###################### ###################
############ ### #################### ########################################## ###################
############ ### #################### ########################################## ###################
############ ###                      ########## ############################### ###################
I            ###############                       #############################                  ##
############ ################################### ################################################ ##
############                 ##################                                                   ##
####################################################################################################